Shortest Path in 5 Steps 
[[-1.  1.  1.  1. -1.]
 [ 1.  1. -2.  1.  1.]
 [ 1. -2.  1. -2.  1.]
 [ 1.  1. -2.  1.  1.]
 [-1.  1.  1.  1. -1.]]
Press Cell: [ 3.  5.]
[[-1.  1.  1.  1. -1.]
 [ 1.  1. -2.  0.  0.]
 [ 1. -2.  1. -2.  0.]
 [ 1.  1. -2.  0.  0.]
 [-1.  1.  1.  1. -1.]]
Press Cell: [ 3.  3.]
[[-1.  1.  1.  1. -1.]
 [ 1.  0. -2.  1.  0.]
 [ 1. -2.  0. -2.  0.]
 [ 1.  0. -2.  1.  0.]
 [-1.  1.  1.  1. -1.]]
Press Cell: [ 3.  1.]
[[-1.  1.  1.  1. -1.]
 [ 0.  1. -2.  1.  0.]
 [ 0. -2.  0. -2.  0.]
 [ 0.  1. -2.  1.  0.]
 [-1.  1.  1.  1. -1.]]
Press Cell: [ 5.  3.]
[[-1.  1.  1.  1. -1.]
 [ 0.  1. -2.  1.  0.]
 [ 0. -2.  0. -2.  0.]
 [ 0.  0. -2.  0.  0.]
 [-1.  0.  0.  0. -1.]]
Press Cell: [ 1.  3.]
[[-1.  0.  0.  0. -1.]
 [ 0.  0. -2.  0.  0.]
 [ 0. -2.  0. -2.  0.]
 [ 0.  0. -2.  0.  0.]
 [-1.  0.  0.  0. -1.]]
