Shortest Path in 6 Steps 
[[ 1. -1.  1. -1.  1.]
 [ 1.  1. -2.  1.  1.]
 [ 1.  1.  1.  1.  1.]
 [ 1. -2.  1.  1.  1.]
 [ 1. -1.  1. -1.  1.]]
Press Cell: [ 1.  3.]
[[ 1. -1.  0. -1.  1.]
 [ 1.  0. -2.  0.  1.]
 [ 1.  1.  1.  1.  1.]
 [ 1. -2.  1.  1.  1.]
 [ 1. -1.  1. -1.  1.]]
Press Cell: [ 2.  3.] Special Cell
[[ 1. -1.  1. -1.  1.]
 [ 1.  1. -2.  1.  1.]
 [ 1.  1.  0.  1.  1.]
 [ 1. -2.  1.  1.  1.]
 [ 1. -1.  1. -1.  1.]]
Press Cell: [ 5.  1.]
[[ 1. -1.  1. -1.  1.]
 [ 1.  1. -2.  1.  1.]
 [ 1.  1.  0.  1.  1.]
 [ 0. -2.  1.  1.  1.]
 [ 0. -1.  1. -1.  1.]]
Press Cell: [ 1.  5.]
[[ 1. -1.  1. -1.  0.]
 [ 1.  1. -2.  0.  0.]
 [ 1.  1.  0.  1.  1.]
 [ 0. -2.  1.  1.  1.]
 [ 0. -1.  1. -1.  1.]]
Press Cell: [ 2.  2.]
[[ 0. -1.  0. -1.  0.]
 [ 0.  0. -2.  0.  0.]
 [ 0.  0.  1.  1.  1.]
 [ 0. -2.  1.  1.  1.]
 [ 0. -1.  1. -1.  1.]]
Press Cell: [ 4.  4.]
[[ 0. -1.  0. -1.  0.]
 [ 0.  0. -2.  0.  0.]
 [ 0.  0.  0.  0.  0.]
 [ 0. -2.  0.  0.  0.]
 [ 0. -1.  0. -1.  0.]]
