Shortest Path in 9 Steps 
[[ 1.  1.  1.  1.  1.]
 [ 1. -3.  1. -3.  1.]
 [ 1.  1.  1.  1.  1.]
 [ 1. -3.  1. -3.  1.]
 [ 1.  1.  1.  1.  1.]]
Press Cell: [ 3.  1.]
[[ 1.  1.  1.  1.  1.]
 [ 0. -3.  1. -3.  1.]
 [ 0.  0.  1.  1.  1.]
 [ 0. -3.  1. -3.  1.]
 [ 1.  1.  1.  1.  1.]]
Press Cell: [ 3.  2.]
[[ 1.  1.  1.  1.  1.]
 [ 1. -3.  0. -3.  1.]
 [ 1.  1.  0.  1.  1.]
 [ 1. -3.  0. -3.  1.]
 [ 1.  1.  1.  1.  1.]]
Press Cell: [ 3.  3.]
[[ 1.  1.  1.  1.  1.]
 [ 1. -3.  1. -3.  1.]
 [ 1.  0.  1.  0.  1.]
 [ 1. -3.  1. -3.  1.]
 [ 1.  1.  1.  1.  1.]]
Press Cell: [ 1.  3.]
[[ 1.  0.  0.  0.  1.]
 [ 1. -3.  0. -3.  1.]
 [ 1.  0.  1.  0.  1.]
 [ 1. -3.  1. -3.  1.]
 [ 1.  1.  1.  1.  1.]]
Press Cell: [ 1.  4.]
[[ 1.  0.  1.  1.  0.]
 [ 1. -3.  1. -3.  0.]
 [ 1.  0.  1.  0.  1.]
 [ 1. -3.  1. -3.  1.]
 [ 1.  1.  1.  1.  1.]]
Press Cell: [ 2.  1.]
[[ 0.  1.  1.  1.  0.]
 [ 0. -3.  1. -3.  0.]
 [ 0.  1.  1.  0.  1.]
 [ 1. -3.  1. -3.  1.]
 [ 1.  1.  1.  1.  1.]]
Press Cell: [ 4.  5.]
[[ 0.  1.  1.  1.  0.]
 [ 0. -3.  1. -3.  0.]
 [ 0.  1.  1.  1.  0.]
 [ 1. -3.  1. -3.  0.]
 [ 1.  1.  1.  0.  0.]]
Press Cell: [ 5.  2.]
[[ 0.  1.  1.  1.  0.]
 [ 0. -3.  1. -3.  0.]
 [ 0.  1.  1.  1.  0.]
 [ 0. -3.  0. -3.  0.]
 [ 0.  0.  0.  0.  0.]]
Press Cell: [ 2.  3.]
[[ 0.  0.  0.  0.  0.]
 [ 0. -3.  0. -3.  0.]
 [ 0.  0.  0.  0.  0.]
 [ 0. -3.  0. -3.  0.]
 [ 0.  0.  0.  0.  0.]]
