Shortest Path in 4 Steps 
[[ 1.  1.  1.  1. -1.]
 [ 1. -2.  1. -2. -1.]
 [ 1.  1.  1.  1. -1.]
 [ 1.  1.  1.  1. -1.]
 [ 1.  1.  1.  1. -1.]]
Press Cell: [ 1.  4.]
[[ 1.  1.  0.  0. -1.]
 [ 1. -2.  0. -2. -1.]
 [ 1.  1.  1.  1. -1.]
 [ 1.  1.  1.  1. -1.]
 [ 1.  1.  1.  1. -1.]]
Press Cell: [ 1.  1.]
[[ 0.  0.  0.  0. -1.]
 [ 0. -2.  0. -2. -1.]
 [ 1.  1.  1.  1. -1.]
 [ 1.  1.  1.  1. -1.]
 [ 1.  1.  1.  1. -1.]]
Press Cell: [ 4.  4.]
[[ 0.  0.  0.  0. -1.]
 [ 0. -2.  0. -2. -1.]
 [ 1.  1.  0.  0. -1.]
 [ 1.  1.  0.  0. -1.]
 [ 1.  1.  0.  0. -1.]]
Press Cell: [ 4.  1.]
[[ 0.  0.  0.  0. -1.]
 [ 0. -2.  0. -2. -1.]
 [ 0.  0.  0.  0. -1.]
 [ 0.  0.  0.  0. -1.]
 [ 0.  0.  0.  0. -1.]]
